String	Translation
This matter is of great importance.	此の{この} 問題 は 迚も{とても} 重要 です
Jim was so tired that he lay down and slept.	は 迚も{とても} 疲れる{疲れていた} ので 横になる{横になって} 眠る{眠った}
The gentleman is a very famous pianist.	其の{その} 紳士 は 大変 有名{有名な} ピアニスト である
It was in Tokyo that I first met her father.	私 が 初めて{はじめて} 彼女{彼女の} 父親 に 会う{会った} の は 東京 で だ{だった}
I like volleyball as well as basketball.	私 は バスケットボール と 同様に バレーボール が 好き です
His paintings seem strange to me.	彼{彼の} 絵 は 私 には 奇妙{奇妙に} 思える
All the best wishes on this wonderful day.	素晴らしい{素晴らしき} 日 を 御{お} 迎え 下さい{ください}
"As a matter of fact, he knows very little of the matter."	実のところ 彼 は 其の{その} 件 に就いて{について} 殆ど{ほとんど} 知る{知らない}
The Inca were religious people.	人 は 信心深い 民族 だ{だった}
He is sick.	彼 は 病気 です
The real estate broker was lavish in his spending in Ginza.	其の{その} 不動産屋 は 銀座 で 気前 良く{よく} 金を使う{金を使った}
"I can't even read French, much less speak it."	フランス語 は 読む 事{こと} さえ 出来る{出来ない} のだ{のです} 況して{まして} 話す 事{こと} 等{など} 迚も{とても} 出来る{出来ません}
"You went to the park yesterday, didn't you?"	貴方{あなた} は 昨日 公園 へ 行く{行きました} ね
The aristocrat clings to the glory of his past.	其の{その} 貴族 は 過去 の 光栄{光栄に} しがみ付く{しがみついている}
These flowers bloom earlier than others do.	此の{この} 花 は 早咲き だ
"I knocked on the door, but nobody answered."	ドア を ノック 為る{して} 見る{みた} が 誰も 居る{いなかった}
We took it for granted that she would take part in the speech contest.	勿論 彼女 は 弁論大会 に 参加 為る{する} と 思う{思った}
I didn't know whether to stay here or go to London.	私 は 此処{ここ} に 止まる{とどまる} 可き{べき} か 倫敦{ロンドン} へ 行く 可き{べき} か 分かる{分からなかった}
He is said to be honest.	彼 は 正直者 だ と言われる{と言われている}
Chop the pickled cabbage finely.	塩漬け キャベツ を 細かい{細かく} 切る
"He understands ideas such as ""same"" and ""different."""	彼 は 同じ とか 違う の{の} 様{ような} 考え を 理解 為る{する}
She always clears the table after a meal.	彼女 は 何時も{いつも} 食事 の 後片付け を 為る{する}
He told his brother the story.	彼 は 其の{その} 話 を 弟 に 為る{した}
It's awfully hot today.	今日 は 凄く{すごく} 暑い
I feel as if I were aboard a great ship.	大船に乗る{大船に乗った} 気持ち が 為る{する}
Your imagination is running away with you.	思いすごし です よ
Hawaii's really the land of milk and honey.	布哇{ハワイ} って 正に{まさに} パラダイス だもの
He is looked up to by all as their leader.	彼 は 指導者 として 皆 に 尊敬 為れる{されている}
I know nothing about her.	彼女 に就いて{について} は 何も 知る{知りません}
"She handed me the basket and suggested I wait until I got home to open it, in case anyone was watching."	彼女 は バスケット を 僕 に 手渡す{手渡し} 誰か が 見る{見ている} と 行けない{いけない} から 家 に 帰る{帰り} 着く 迄{まで} 開ける の を 待つ{待ったら} 如何{どう} か と 言う{言った}
Should I put out my cigarette now?	今 煙草{タバコ} を 消す{消さ} ねばならない{なければならない} のだ{のです} か
There is nothing that does not decay.	朽ちる{朽ちない} 物 は 何もない
He is the greatest singer that ever lived.	彼 は 今まで 最大 の 歌手 だ
He is sure of success in the end.	彼 は 最後 には 成功 為る{する} と 確信 為る{している}
He is older than any other student in his class.	彼 は クラス の 中 で 最年長 に 当たる{あたる}
You learn a lot about your own country if you live abroad.	外国 に 住む と 自分 の 国 の 事{こと} が 良い{良く} 分かる
He is senior to me by three years.	彼 は 私 より 三 才{歳} 年上 だ
"This book is interesting and, what is more, very instructive."	此の{この} 本 は 面白い{おもしろい} その上 非常に 為になる{ためになる}
"Who drives better, your father or your mother?"	お父さん と お母さん と 何方{どちら} が 運転 が 上手 ですか
You are free to do as you please with your money.	君 は 好きなように 君{君の} お金 を 処分 為る{して} 良い{よい}
Everybody was bright at the party.	其の{その} 会 で は 皆{みんな} が 陽気 だ{だった}
This book is fundamental for an understanding of biology.	此の{この} 本 は 生物学 を 理解 為る{する} 基礎 となる 物{もの} だ
This lesson is cancelled tomorrow.	此の{この} 授業 は 明日 休講 です
How about staying with us for a few days?	私たち{私達} の 所 に 数日 泊まる{泊ったら} 如何{いかが} ですか
I have no ear for music.	私 は 音楽 の 事{こと} は 分かる{分かりません}
I have to study Japanese.	私 は 日本語 を 勉強{勉強し} ねばならない{なければなりません}
This is her weak point.	此れ{これ} が 彼女{彼女の} 弱点 です
I've gone and caught a cold.	風邪をひく{風邪を引いて} 仕舞う{しまった}
The other day I went fishing for the first time in my life.	先日 生まれて初めて 魚釣り に 行く{行った}
This matter must be dealt with sooner or later.	此の{この} 問題 は 遅かれ早かれ 片付ける{片づけ} ねばならない
I waited for her for a long time.	私 は 長い間 彼女 を 待つ{待った}
Snow lay all over the ground.	雪 は 辺り{あたり} 一面 に 積もる{積もっていた}
"I know him by sight, but not by name."	私 は 彼 の 顔 は 知る{知っている} が 名前 は 知る{知らない}
He's afraid of the sea.	彼 は 海 を 怖がる
"From the 5th to the 15th of January, please."	一月{１月} 五日{５日} から 一月{１月} 日 迄{まで} お願いします{おねがいします}
This is the cutest baby that I have ever seen.	此れ{これ} は 今まで 見る{見た} 中 で 一番 可愛い{かわいい} 赤ちゃん です
The manufacturing sector is a frenzy over the new monetary policy.	製造 部門 は 新しい 金融 政策 に 動揺 為る{しています}
The mother elephant bathes her baby in the river.	母親 の 象 は 川 の 中 で 小象 の 体 を 洗う{あらって} 遣る{やります}
"Having been convicted of murder, he was sentenced to life imprisonment."	殺人 の 有罪 宣告 を 受ける{受け} 彼 は 終身刑 を 科する{科せられた}
"Oh, sure, I studied English in my school days. But it wasn't until two or three years ago that I really started taking it seriously."	勿論{もちろん} 学生時代 に 英語 は 勉強{勉強した} けど 本格的{本格的に} 始める{始めた} の は 此処{ここ} 年 位{くらい} 前 です
Will it clear up this afternoon?	午後 は 晴れる だろうか
Did you receive my letter?	手紙 は 届く{届きました} か
He came tumbling after.	彼 は 蹌踉めく{よろめき} 乍ら{ながら} 後 から 付いてくる{ついてきた}
May I ask you to call me back later?	後で もう一度 掛け直す{かけ直して} 頂ける{いただけます} か
Visitors to Switzerland admire the Alps.	瑞西{スイス} を 訪れる 人{ひと} は アルプス に 感嘆 為る{する}
Why did you use up all the money?	君 は 何故{なぜ} お金 を 使い果たす{使い果たした} の か
A stranger asked the girl whether her father was at home or at his office.	お父さん は 御{ご} 在宅 か ね 其れ共{それとも} 会社 か ね と 見知らぬ 人 が 其の{その} 少女 に 尋ねる{尋ねた}
She is confident of her son's success.	彼女 は 息子 の 成功 を 確信 為る{している}
He is hunted by the police.	彼 は 警察 に 追う{追われている}
He has just as many books as his father does.	彼 は 父 と 同じくらい 沢山{たくさん} の 本 を 持つ{持っている}
He knows better than to fight with his boss.	彼 は 上司 と 喧嘩{けんか} を 為る{する} 程{ほど} 愚か では無い{ではない}
He failed to follow our advice.	彼 は 我々 の 忠告 を 聞き入れる{聞きいれなかった}
"Even if it takes you three years, you must accomplish your goal."	仮令{たとえ} 年 掛かる{かかって} も 君 は 自分 の 目的 を 成し遂げる{成し遂げ} ねばならない{なければならない}
"The moment he saw me, he grew pale and ran away."	彼 は 私 を 見る と 直ぐに{すぐに} 青ざめる{青ざめて} 逃げ出す{逃げ出した}
How did she ever pass the test?	彼女 は 一体 どうやって 其の{その} 試験 を パス 為る{した} の かしら
I am at the end of my patience.	私 は 辛抱 為る{し} 切れる{きれなく} 成る{なった}
It was a poor choice of words under the circumstances.	こう言う 状況 で は 旨く{うまく} 言葉 が である{でなかった}
"My father was, I think, a little drunk then."	父 は 思う に 彼の{あの} 時{とき} 少し 酔う{酔っていた} のだ と 思う
The conductor of this orchestra is a fine musician.	此の{この} オーケストラ の 指揮者 は 優れる{優れた} 音楽家 です
I usually keep a diary when I travel.	私 は 普通{ふつう} 旅行 為る{する} 時{とき} は 日記を付ける{日記をつける}
"If you watch this TV drama, you will understand the lives of ordinary people in the Edo Age very well."	此の{この} テレビドラマ を 見る{見れば} 江戸時代 の 庶民 の 暮らし振り{暮らしぶり} が 良く{よく} 分かる{わかります}
"Come here, and you can see the sea."	此処{ここ} へ 来る{来} なさい そうすれば 海 が 見える よ
He wetted his towel with water.	彼 は タオル を 水 で 濡らす{濡らした}
I went to the hospital to inquire after his health.	私 は 彼{彼の} 安否 を 尋ねる{尋ね} に 病院 へ 行く{行った}
"The Department of Homeland Security's primary function is the prevention of terrorist attacks occurring within America and, in the extreme case of an attack happening, holding losses to the smallest possible level and swiftly carrying out restoration."	国土安全保障省 の{の} 主要業務 は 米国 内 の テロ攻撃 を 未然 に 防ぐ{防ぎ} 万一 発生 為る{した} 場合 は 被害 を 最小限 に 食い止める{食い止め} 速やか{速やかな} 復旧 を 実施 為る{する} 事{こと} に 有る{ある}
This tree is the tallest and oldest in this forest.	此の{この} 木 は 此の{この} 森 の 中 で 一番 高い{高くて} 古い
She cannot work this machine.	彼女 は 此の{この} 機械 を 動く{動かせない}
Stop resting your elbows on the table.	テーブル に 肘{ひじ} を 突く の は 止める{やめ} なさい
I suppose you're hungry.	君 は 空腹 だ と 思う
We hired a boat by the hour in the park.	私たち は 公園 で ボート を 時間 単位 で 借りる{借りた}
I was full of curiosity about her past.	私 は 彼女{彼女の} 過去 に就いて{について} 好奇心 で 一杯{いっぱい} だ
This is too heavy a box for me to carry.	此れ{これ} は 大変 重い 箱 なので 私 には 運ぶ{運べない}
One of the aircraft's engines cut out.	飛行機 の エンジン の 一つ が 止まる{止まって} 仕舞う{しまった}
I'll be busy next week.	来週 は 忙しい{忙しく} 成る{なり} そう だ
Sachiko is more popular than Judy.	さん は さん よりも 人気 が 有る{あります}
The rotten apple injures its neighbors.	腐る{腐った} 林檎{りんご} は 仲間 を 腐る{腐らせる}
He gave me what little money he had about him.	彼 は 少ない 乍らも{ながらも} 持ち合わせる{持ち合わせていた} 金 を 全部 私 に 呉れる{くれた}
Clans run wild like a storm in a raging sea.	猛り狂う 海 の 嵐 の様に{のように} 一族 が 激しい{激しく} 走る
Can you tell me where the nearest zoo is?	一番 近い 動物園 は 何処{どこ} に 有る{ある} か 教える{教えて} 頂ける{いただけます} か
I am afraid to jump over the ditch.	怖い{恐くて} 其の{その} 溝 を 飛び越す{跳び越せない}
She set him to chopping wood.	彼女 は 彼 に 薪{まき} を 割る{割らせた}
He had already gone.	彼 は もう 行く{行って} 仕舞う{しまった}
His hair has turned white.	彼{彼の} 髪 は 白い{白く} 成る{なった}
I can't think of any other plan.	私 は その他 の 計画 を 思いつく{思い付かない}
An actor has to memorize his lines.	役者 は 台詞 を 暗記 為る{し} ねばならない{なければならない}
It is characteristic of him.	其れ{それ} は 如何にも{いかにも} 彼 らしい
You belong to the next generation.	君たち は 次{次の} 世代 の 人間 だ
I want to come to terms with him.	彼 と 仲直り したい
England established many colonies.	英国 は 多く の 植民地 を 設ける{設けた}
"I love trying out new things, so I always buy products as soon as they hit the store shelves. Of course, half the time I end up wishing I hadn't."	私 って 新しいもの好き で 店 で 新製品 食べ物 を 見る{みる} と 直ぐ{すぐ} 買う{買って} 仕舞う{しまう} でも その内{そのうち} 半分 は 失敗 為る{する} ね
He wore a robe over his pajamas.	彼 は パジャマ の 上 に 部屋着 を 着る{着ていた}
Zen's latest mission is to save the Earth from ecological destruction at the hands of a plant-destroying madman.	の 最新{最新の} 任務 は 緑 の 絶滅 を 図る 狂人 に依る{による} 生態系 破壊 から 地球 を 救う 事{こと} です
Please put down my address in case you forget it.	忘れる と 行けない{いけない} ので 私{私の} 住所 を メモ 為る{して} 下さい{ください}
The whole village was consumed by the fire.	全村 が 火事 で 焼ける{焼けてなく} 成る{なった}
"Whether it rains or shines, I will start tomorrow."	降る{降って} も 晴れる{晴れて} も 明日 は 出発{出発します}
I have few friends.	友人 は 少し しか 居る{いない}
"Hanako made the final payment on her car, and felt very satisfied."	は 車 の 最後 の ローン を 支払う{支払い} 迚も{とても} 満足 為る{した}
"J. Kepler, astronomer and mathematician, made a study of planets and their movements."	天文学者 で 数学者 である{であった} は 惑星 と 其の{その} 運動 に就いて{について} の 研究 を 為る{した}
We have to buy water from Malaysia.	水 を マレーシア から 買う{買わ} 無くてはならない{なくてはならない} のだ{のです}
"I'm looking for a coat. I'm short so the length should be on the short side, and as refined a design as possible."	コート を 探す{探してます} 背が低い ので 丈 は 短め で 成るべく{なるべく} すっきり 為る{した} デザイン の 物{もの} を
We guarantee our products for one year.	保証 は 一年間 です
"If you have a certificate of immunization, please bring it when you come."	若し{もし} 予防接種 証明書 が 有る{あったら} 持つ{お持ち} 下さい{ください}
Riding a horse is really thrilling.	馬 に 乗る 事{こと} は 本当に スリル が 有る{ある}
The cherry trees are in full bloom.	桜 の 木 が 満開 だ
Sugar replaced honey as a sweetener.	甘味料 として 砂糖 が 蜂蜜{はちみつ} に 取って代わる{取って代わった}
I'll never see him again as long as I live.	私 は 生きる{生きている} 間 は 決して 再び 彼 とは 会う{会わない}
He may well be proud of his sons.	彼 が 息子 達 を 自慢 為る{する} の も 尤も{もっとも} だ
Tom takes good care of the birds.	は 小鳥 の 世話 を 良くする{よくする}
It is difficult for him to buy a car.	彼 は 自動車 を 買う 事{こと} が 困難 である
The man had something under his coat.	其の{その} 男 は コート の 裏側 に 何か 持つ{持っていた}
I am tired of eating at the school cafeteria.	学食 に 飽きる{飽きた}
Do I sound in love?	私 が 恋をする{恋をしている} 様に{ように} 聞こえる{聞こえます} か
It is quite a big number.	其れ{それ} は 可也{かなり} 大きな 数 だ
She is dependent on her parents even after her marriage.	彼女 は 結婚 後 でも 両親 に 頼る{頼っている}
I'll look after the children while you go shopping.	貴方{あなた} が 買い物 に 行く{行っている} 間 子供たち{子供達} の 面倒を見る{面倒を見ましょう}
I wish I could go with you today.	今日 貴方{あなた} と 一緒に 行く{行ける} と 良い{いい} のだ{んです} が
"Yeah, it's been a long time."	本当{ほんと} 随分 久しぶり だ{じゃない}
He ought to be ashamed of his ignorance.	彼 は 自分 の 無知 を 恥ずかしい と 思う 可き{べき} だ
He glanced at her.	彼 は 彼女 を ちらっと見る{ちらっと見た}
I was disappointed when I heard that you couldn't come.	貴方{あなた} が お出でになる{お出でになれない} 事 を 聞く{聞いて} がっかり 為る{しました}
They washed themselves in the river.	彼ら は 川 で 体{身体} を 洗う{洗った}
He is trying to keep up with the current of the times.	彼 は 時代の流れ に 遅れる{遅れない} ようにする{ようにしている}
"In short, all our efforts resulted in nothing."	要するに{ようするに} 私たち の 努力 は 全て{すべて} 無 に 帰す{帰した}
Don't walk so fast. I can't keep up with you.	そんなに 早く 歩く{歩かないで} 付いて行ける{ついていけない} わ
They entered his name on the list.	彼ら は 彼{彼の} 名前 を 名簿 に 乗せる{載せた}
"You're interested in this sort of thing? ""No, not really."""	こう言う{こういう} の 興味 有る{ある} のだ{のです} か そう言う 訳じゃない{わけじゃありません}
Captain Cook thanked the natives for their hospitality.	クック 船長 は 其の{その} 原住民 達 の 手厚い 持て成し{もてなし} に 感謝 為る{した}
"I looked in the direction of the window, but didn't see anything."	窓 の 方 へ 目を向ける{目を向けた} が 何も{なにも} 見える{見えなかった}
It is a childish act.	其れ{それ} は 子供じみた 行い です
The frequency of crime in the town is high.	此の{この} 町 に於ける{における} 犯罪 の 発生率 は 高い
"The rain hasn't stopped yet, has it?"	雨 は 未だ{まだ} 止む{やんでいません} ね
I like all of them.	彼ら が 皆{みんな} 好き だ
There is little coffee left in the pot.	ポット には 殆ど{ほとんど} 珈琲{コーヒー} は 残る{残っていない}
I couple this song with his name.	私 は 此の{この} 歌 を 聞く と 彼{彼の} 名 を 連想 為る{する}
"Since I was thirsty, I drank water."	喉が乾く{のどが渇いた} ので 水 を 飲む{飲んだ}
Three boys came in. I spoke to the boy who seemed to be the oldest.	少年 が 三人{３人} 入る{入って} 来る{きた} 私 は 最も 年上 と 思う{思われる} 少年 に 話しかける{話しかけた}
I have caught a bad cold.	悪い 風邪をひく{かぜをひきました}
You shouldn't have gone to such a dangerous place.	そんな 危険{危険な} 所 に 行く 可き{べき} だ{ではなかった} のに
I have known him a long time.	私 は 彼 と 知り合う{知り合って} 長い
A broad river runs through the city.	大きな 川 が 其の{その} 市 を 貫く{貫いて} 流れる{流れている}
That's a nice T-shirt.	素敵{すてきな} Ｔシャツ です ね
She is more pretty than beautiful.	彼女 は 美しい と言うより 可愛い{かわいい}
To what degree can we trust him?	私たち は 彼 を 何の{どの} 程度 迄{まで} 信頼 す可き{すべき} か
Excuse me. That fare is not enough.	もしもし 料金 不足 です よ
"May I take this umbrella? ""No, you may not."""	此の{この} 傘 を 持っていく{持っていって} も 良い{よい} ですか 否{いいえ} 行けない{いけません}
"The results he has got are, in the main, satisfactory."	彼 が 得る{得た} 結果 は 大部分 は 満足 す可き{すべき} ものである
A tiger is bigger and stronger than a cat.	虎{トラ} は 猫 より 大きい{大きくて} 強い
None of these offices have air-conditioning.	此処{ここ} の 事務所 には 何処にも{どこにも} 冷房 が 無い{ない}
I grew tomatoes last year and they were very good.	去年 トマト を 作る{作った} が 迚も{とても} 美味しい{おいしかった}
Prophets have been forecasting the end of the world for centuries.	預言者 は 何 世紀 物{もの} 間 この世{この世の} 終わる{終わり} を 予言 為る{し} 続ける{続けて} 来る{きた}
I am convinced of the truth that he was in love with my sister.	私 は 彼 が 私{私の} 姉 を 愛する{愛している} と言うのは{というのは} 本当 だ と 確信 為る{している}
Have you got a red pencil?	赤 鉛筆 を 持つ{持っています} か
He succumbed to authority.	彼 は 権力 に 屈する{屈した}
She attended the meeting.	彼女 は 其の{その} 会合 に 出席 為る{した}
It is surprising how little she knows of the world.	彼女 が 如何に{いかに} 世間 を 知る{知らない} か 驚く 程{ほど} だ
He told me that he was very tired then.	彼 は 私 に 今 大変 疲れる{疲れている} と 言う{いった}
Are we humans alone in this infinite universe?	此の{この} 果てしない 宇宙 に 居る{いる} の は 私たち 人類 丈{だけ} ですか
I'm going to have my eyes examined.	私 は 目 の 検査 を 為る{して} 貰う{もらう} 積もり{つもり} だ
He said the words in a very small voice.	彼 の 其の{その} 言葉 を 迚も{とても} 小さな 声 で 言う{言った}
Grandma is three and a half times your age.	祖母 の 年齢 は 貴方{あなた} の 倍 半 である
We soon believe what we desire.	願う{願っている} 事{こと} は 直ぐに{すぐに} 信じる
They must have made a mistake.	彼ら は 誤る{誤った} に違いない
He made an admission that he had lied.	彼 は 嘘をつく{うそをついた} と 認める{みとめた}
"At my joke, the audience burst into laughter."	私{私の} 冗談 に 聴衆 は どっと 笑い出す{笑い出した}
The Earth is a small but beautiful planet.	地球 は 小さい けど 美しい 惑星 だ
I want nothing but health.	私 が 欲しい の は 健康 丈{だけ} だ
He's dry and unemotional.	彼 は ドライ ですから ね
"Surpassing labour intensive, capital intensive, the age has shifted greatly to knowledge intensive."	労働集約 資本集約 を 越える{超えて} 時代 は ナレッジ インテンシブ へ と 大きく シフト 為る{している}
"By the way, where do you live?"	所で{ところで} 君 は 何処{どこ} に 住む{住んでいる} の
You are making history.	皆さん は 歴史 を 作る{つくっています}
We should look into the problem.	私たち は 其の{その} 問題 を 調査 為る{する} 可き{べき} だ
We caught the thief.	泥棒 を 捕まえる{捕まえた}
The scholar carried out his lifework at the age of seventy.	其の{その} 学者 は 才 で ライフワーク を 完成 為る{した}
I hope today's ball game won't be canceled.	今日 の フットボール の 試合 が 中止 になる{になら} 無ければ{なければ} 良い{いい} の{ん} だ が
He looks just like his mother.	彼 は 全く{まったく} 母親 に そっくり だ
A start should be made at once.	直ぐ{すぐ} 始める{始め} ねばならない{なければならない}
She is gentle with children.	彼女 は 子供たち{子供達} には 優しい{やさしい}
He was very badly situated.	彼 は 苦境 に 会う{会った}
We got up at dawn.	私たち は 夜明け に 起きる{起きた}
He has got as many as fifty novels written in English.	彼 は 冊 も の 英語 で 書く{書かれた} 小説 を 持つ{持っている}
I'm sure it was just a terrible accident.	此れ{これ} は 屹度{きっと} 恐ろしい 事故 に 違い 有る{ありません}
I never imagined we'd be talking about this topic today.	今日 此の{この} 話題になる とは 全く 予期 為る{していませんでした}
The teacher and I sat face to face.	先生 と 私 は 向かい合う{向かい合って} 座る{座っていた}
I will have been studying for five years next February.	私 は 今度 の 二月{２月} で 年間 勉強{勉強している} 事になる{ことになります}
He scattered the coins of the money-changers and overturned their table.	両替人 の 金 を 散らす{散らし} 其の{その} 台 を 倒す{倒した}
I am pleased with my new house.	私 は 新しい 家 が 気に入る{気に入っている}
He grew up to be an engineer.	彼 は 成長 為る{して} 技師 になる{になった}
Then a good idea came into my mind.	其の{その} 時{とき} 良い 考え が 私{私の} 心に浮かぶ{心に浮かんだ}
He is a complete stranger to me.	彼 は 私{私の} 全て{すべて} を 知る{知らない} 人 だ
We shouted for help at the tops of our voices.	私たち は 声 を 振り絞る{振り絞って}  助け を 求める{求めた}
Today cars are so popular that we assume everyone has one.	今日 車 は 迚も{とても} 普及 為る{している} ので 私たち{私達} は 誰でも 車 を 持つ{持っている} と 思い込む{思い込んでいる}
Let's wait until he wakes up.	彼 が 目を覚ます 迄{まで} 待つ{待ちましょう}
We sail for San Francisco on Monday.	私たち の 船 は 月曜日 に サンフランシスコ へ 向ける{向けて} 出港 為る{します}
A is 5 times as long as B.	は の 五倍{５倍} の 長さ が 有る{ある}
"I have little, if any time that I can call my own."	私 は 自分 の 時間 と言うもの{というもの} を 殆ど{ほとんど} 持つ{持っていない}
"If you are going to the safari park, take the No.5 bus."	サファリパーク に いらっしゃる なら 番 の バス です
He showered abuse on me.	彼 は 私 に 毒舌 を 浴びせる{浴びせた}
I want to make her acquaintance.	私 は 彼女 と 近づく{近づき} になる{になり} たい
He got tired soon.	彼 は 直ぐに{すぐに} 疲れる{疲れた}
This is the place where she works as a secretary.	此処{ここ} が 彼女 が 秘書 として 働く{働いている} 所 です
But he likes the long school holidays.	でも 彼 は 長い 学校 の 休み が 好き なのだ{なんだ} よ
Could you tell me your present address?	貴方{あなた} の 現住所 を 私 に 言う{言って} 下さる{下さいます} か
You must pay attention to what your teacher says.	先生 の 言う 事{こと} に 注意 を 為る{し} ねばならない{なければならない}
Would you mind putting her on the phone?	彼女 を 電話 に 出す{出して} 頂ける{頂けません} か
That word describes it perfectly.	其の{その} 言葉 が 其れ{それ} を 説明 為る{する} には ぴったり だ ね
He always seems to be living rent-free in somebody's house.	彼 は 何時も{いつも} 何処か{どこか} の 家 に 居候 為る{している}
Man seems to need drama as much as he needs religion.	人類 は 宗教 を 必要とする の と 同じくらい に ドラマ を 必要とする 様だ{ようだ}
There was no one in the room.	部屋 の 中 には 誰も 居る{いませんでした}
I will look into the matter.	其の{その} 件 に就いて{について} 調べる{調べて} 見る{みましょう}
I was stupid to make a mistake like that.	そのよう{そのような} 間違い を 為る{する} なんて 私 は 愚か だ{だった}
Why do you need it?	どんな 事{こと} で 其れ{それ} が 必要 ですか
It is said that global warming is directly related to carbon dioxide emissions.	地球温暖化 は 二酸化炭素 の 排出 と 直接関係 が 有る{ある} と言われる{と言われている}
We need twenty eggs all told.	全部 で 個 の 卵 が 必要 です
Tom puts too much sugar in his tea.	は 紅茶 の 中 へ 砂糖 を 入れる{いれ} 過ぎる{すぎます}
I will make every effort to get it.	私 は 其れ{それ} を 得る 為に{ために} 有らゆる{あらゆる} 努力 を 為る{します}
A Mr Sakaki has come to see you.	さん とか 言う{いう} 方 が 見える{お見え} になる{になりました}
Yokohama is the city in Japan with the second largest population.	横浜 は 日本 で 番目 に 人口 が 多い 市 だ
The job offer still stands.	彼の{あの} 仕事{仕事の} 口 は 未だ{まだ} 有る{ある} よ
I have a nice present to give you.	君 に 良い{いい} 贈り物 を 上げる{あげましょう}
This may be of use to you.	此れ{これ} は 貴方{あなた} の 役に立つ かも知れない{かもしれない}
He gave me a smile of recognition.	彼 は 私 の{の} 事{こと} が 分かる{わかって} 微笑む{ほほえんだ}
"He asked me whether she had given me the book, or if I had bought it myself."	彼女 が 私 に 其の{その} 本 を 呉れる{くれた} の か 其れ共{それとも} 私 が 自分で 其れ{それ} を 買う{買った} の か と 彼 は 私 に 尋ねる{尋ねた}
Food must be chewed well to be digested properly.	良く{よく} 消化 為る{する} 為に{ために} は 食べ物 を 十分 噛む{かま} ねばならない
He always reads a magazine.	彼 は 何時も{いつも} 雑誌 を 読む
He closed the door suddenly.	彼 は バタン{ばたんと} ドア を 閉める{閉めた}
"I have tried for hours to remember where I put my keys, but it has completely escaped me."	何時間 も の 間 何処{どこ} に 鍵 を 置く{置いた} の か 思い出す{思い出そう} とする{とした} が 全然 思い出す{思い出せなかった}
It's difficult to evaluate his ability.	彼{彼の} 能力 を 評価 為る{する} 事{こと} は 難しい
His story was highly amusing to us.	彼{彼の} 話 は 迚も{とても} 面白い{面白かった}
I did smoke when I was young.	私 は 若い頃{若いころ} 煙草を吸う{煙草を吸った}
He succeeded in solving the question.	彼 は 旨く{うまく} 其の{その} 問題 が 解ける{解けた}
May I ask some questions?	幾つか{いくつか} 質問 為る{して} も 良い{いい} ですか
I'd like to buy this doll.	此の{この} 人形 が 欲しい のだ{のです} が
He apologized for having offended her.	彼 は 彼女 を 怒る{怒らせた} 事{こと} を 詫びる{詫びた}
Which house did you live in?	何の{どの} 家 に 住む{住んでいた} のだ{のです} か
He has very little interest in his children.	彼 は 自分 の 子供たち{子供達} に 殆ど{ほとんど} 関心 が 無い{ない}
I wonder if it would be possible for you to introduce me to Mr Harrison of PC Interactive Co. Ltd?	インタラクティブ 社 の 氏 を 御{ご} 紹介 為る{して} 頂ける{いただけません} でしょうか
I like pro wrestling.	私 は プロレス が 好き です
I remember singing that song long ago.	昔{昔の} 彼の{あの} 歌{うた} を 歌う{歌った} 事{こと} を 覚える{覚えています}
For all her riches she is not happy.	彼女 は あんなに 御{お} 金持ち だ{な} の{の} に 幸せ では無い{ではない}
This play has no humor in it.	此の{この} 芝居 には ユーモア が 無い{ない}
In Japan people take off their shoes when they enter a house.	日本 で は 家 に 入る 時 に 靴 を 脱ぐ
Who is she speaking to?	彼女 は 誰 に 話しかける{話しかけている} のだ{のです} か
Have the devil's own luck.	悪運 が 強い
She started dancing when she was eight.	彼女 は 八 才{歳} の 時{とき} に ダンス を 始める{始めた}
There is little furniture in my house.	私{私の} 家 には 家具 が 殆どない{ほとんどない}
At times I feel sad.	時折 私 は 悲しい{悲しく} 成る{なる}
I cannot but object to his proposal.	私 は 彼{彼の} 提案 に 反対 せざるを得ない
This car is always breaking down lately.	此の{この} 車 は 近頃{近ごろ} 故障 許り{ばかり} 為る{している}
You have infinite possibilities as an artist.	貴方{あなた} は 芸術家 として の 無限{無限の} 可能性 を 秘める{秘めている}
He crossed me up.	彼 は 私 を 裏切る{裏切った}
You must take into account the fact that she was ill.	貴方{あなた} は 彼女 が 病気 だ{だった} と 言う{いう} 事{こと} を 考慮に入れる{考慮に入れ} ねばならない{なければならない}
"I missed the last bus, and was obliged to walk home in the rain."	私 は 終バス に 乗り遅れる{乗り遅れて} 家{うち} 迄{まで} 雨 の 中 を 歩く{歩か} ねばならない{なければならなかった}
Don't rush into the situation until you have all the details; hold your horses until you know where you are going.	詳しい 事{こと} が 全部 分かる{わかる} 迄{まで} は 慌てる{あわてて} その場 に 踏み込む{ふみこむ} な 見当がつく 迄{まで} は 慎重{慎重に} 構える{かまえて} 居る{おれ}
People have eaten with their fingers from the beginning of history.	人類 は 太古 の 昔 から 指 を 用いる{用いて} 食べ物 を 食する{食して} 来る{きた} の である
I think you had better stick to your present job.	貴方{あなた} は 現在 の 仕事 を 続ける{続けた} 方がいい と 思う{思います}
Will you help me for a minute?	一寸{ちょっと} 私 を 助ける{たすけて} 呉れる{くれません} か
"Oh, the driver is a maniac."	なあ 此の{この} 運転士 いかれる{いかれてる} よ
He managed to pass the examination.	彼 は 試験 に 何とか{なんとか} 合格 為る{した}
Don't work too hard.	働き過ぎる{働き過ぎない} 様に{ように}
Tea is like the lubricating oil of work to allow it to proceed smoothly.	お茶 は 仕事 を スムーズ に 運ぶ{運ばせる} 為{ため} の{の} 潤滑油 の{の} 様{ような} 物{もの}
"Suddenly, a terrible storm came up."	突然 恐ろしい 嵐 が やって来る{やってきた}
"If anyone should phone, say I will be back at one o'clock."	誰か から 電話 が 有る{あったら} 一時 に 戻る と 言う{いって} 下さい
"In the first place, we must be careful about what we eat and drink."	第一 に 飲食 に 注意 為る{し} ねばならない{なければならない}
I missed the 7:00 train.	時 発 の 電車 に 乗り遅れる{乗り遅れた}
This soup wants a bit of salt.	此の{この} スープ は 塩 が 少し 足りる{足りない}
That car is a real beauty.	彼の{あの} 車 は 全く 素晴らしい{すばらしい} 物{もの} だ
Tom feels that his team will win the game.	は 自分 の チーム が 試合 に 勝つ だろう と 思う{思っている}
How are the kids?	子供たち は 元気
He is no good as a doctor.	彼 は 医者 として 無能 だ
I will do anything but this.	此れ{これ} 以外 の 事{こと} なら 何でも 為る{する}
Let's hash it all out.	とことん 話し合う{話し合って} 分かる{わかりあおう} よ
He went into teaching.	彼 は 教職 に 就く{就いた}
Take a look at this map.	一寸{ちょっと} 此の{この} 地図 を 見る{見} なさい
People used to think that only humans could use language.	人々 は 人間 しか 言語 を 使える{使えない} と 以前 は 考える{考えていた}
"Though she is rich, she is not happy."	金持ち に 関らず{かかわらず} 彼女 は 幸せ である{でない}
They are pleased with your work.	彼ら{彼等} は 仕事 に 満足 為る{している}
The frequency of crime in the town is high.	此の{この} 町 に於ける{における} 犯罪 の 発生率 は 高い
The admission is ten dollars a person.	一人 ドル です
The astronaut was slow to get used to the condition of weightlessness.	其の{その} 宇宙飛行士 は 無重力 の 状態 に 中々{なかなか} 慣れる{慣れなかった}
"I said, ""Could you please turn your television down?"""	テレビ の 音 を 小さい{小さく} 為る{して} 貰う{もらえません} か って 言う{言った} のだ{んです} よ
She played an important part in the drama.	彼女 は 其の{その} ドラマ で 重要{重要な} 役 を 演じる{演じた}
What to do next is the question.	次 に 何 を す可き{すべき} か が 問題 である
You should restore the money he lost to him.	君 は 彼 に 彼 が 無くす{なくした} お金 を 戻す 可き{べき} だ
Will you notify me after 3 minutes?	分 経つ{たったら} 教える{教えて} 貰う{もらえます} か
The hotel charged me 8000 yen for the room.	ホテル は 部屋代 として 私 に 円 請求 為る{した}
She continued writing in her diary until she died.	彼女 は 死ぬ 迄{まで} 日記 を 書く{書き} 続ける{つづけた}
Did you enjoy watching the night game last night?	昨夜 は ナイター を 見る{見て} 楽しむ{楽しみました} か
Mischief is common to most children.	悪戯{いたずら} は 大抵{たいていの} 子供 に 共通{共通の} 物{もの} だ
Each country has its own customs.	所 変わる{変われば} 品 変わる
Advance two steps.	歩 前 に 出る{出} なさい
Here are your boarding pass and your baggage claim.	搭乗券 と 荷物 の 引き換え証 です
He was in such a good mood when his team won the championship.	彼 は 自分 の チーム が 選手権 に 勝つ{勝って} 上機嫌 だ{だった}
Mr Smith is in charge of the class.	先生 は 其の{その} クラス の 担任 だ
It is certain that prices will go up.	物価 が 上がる の は 確か だ
You'd better consult an attorney beforehand.	事前 に 弁護士 と 相談 した方がいい よ
All but the boy were asleep.	其の{その} 少年 以外 は 皆{みんな} 眠る{眠っていた}
Making use of fire may be regarded as man's greatest invention.	火 の 利用 が 人類 の 最大 の 発明 と 考える{考えて} も 良い{よい} でしょう
"Hurry, or you'll miss the train."	急ぐ{急がない} と 列車 に 乗り遅れる{乗り遅れます} よ
"Whatever he may say, I won't change my mind."	彼 が 何と 言う{言おう} と 私 は 心変わり 為る{しません}
It is very kind of you to say so.	そう 言う{言って} 呉れる{くれて} 君 は 迚も{とても} 親切 だ
There were quite a few students absent from class today.	今日 授業 を 欠席 為る{した} 学生 は 多い{多かった}
He turned out to be a real disappointment after we went through hell and high water to find him.	鉦 や 太鼓 で 探り当てる{探しあてた} 割に は 彼奴{あいつ} 期待外れ{期待はずれ} だ{だった} よ な
Beyond the novel we come to works whose avowed aim is information.	小説 の 次 には 知識 を 与える 事{こと} を 目的 とする 作品 が 有る{ある}
We cannot meet the demands of the hijackers.	乗っ取る{乗っ取り} 犯人 の 要求 には 応じる{応じられない}
I can't check my mail. The server is down.	サーバ{サーバー} が ダウン 為る{してて} メールチェック 出来る{できない}
What a mean fellow!	何と{なんと} 卑劣{卑劣な} 奴 だ
School begins at half past eight.	授業 は 時半 に 始まる
You're always criticizing me!	君 は 何時も{いつも} 僕 を 批判 為る{している}
"Stand back, please."	どうぞ 後ろ に 下がる{下がって} 下さい{ください}
"Moreover, they underscored the need for providing policy relevant ready-to-use scientific results and methodology."	更に{さらに} 即 戦力 と 成る{なる} 政策関連{政策関連の} 科学的 成果 や 手段 の 提供 が 必要 である と 強調 為る{した}
He returned to America.	彼 は 亜米利加{アメリカ} に 戻る{戻った}
She will cope with all the work.	彼女 なら 仕事 を 全て{すべて} 上手い{上手く} 遣る{やる} だろう
She found pleasure in reading.	彼女 は 読書 に 楽しみ を 見出す{見いだした}
She did not answer all the questions.	彼女 は 必ずしも 全て{すべての} 質問 に 答える{答えた} 訳ではない{わけではない}
Little birds are singing merrily.	小さな 鳥 が 楽しげ{楽しげに} 囀る{さえずっている}
He breathed his last peacefully this morning.	彼 は 今朝 安らか に 息を引き取る{息を引き取った}
Did you see a doctor?	医者 に 見てもらう{診てもらった} の か
He tried writing a short story.	彼 は 試しに 短い 物語 を 書く{書いて} 見る{みた}
He said a few words by way of apology.	彼 は 言い訳 として 二 三 述べる{述べた}
I must remind you of your promise.	約束 為る{した} 事{こと} を 思い出す{思い出して} 下さい
Never before have we had such a strong longing for peace.	此れ{これ} 程{ほど} 迄に{までに} 平和 を 切望 為る{した} 事 は 嘗て{かつて} 無い
Don't stand by me.	僕 の 側{そば} に 立つ{立たないで} 呉れる{くれ} よ
I can only tell you what I know.	私 は 知る{知っている} 事{こと} しか 御{お} 話 出来る{できません}
She was in a silk dress.	彼女 は シルク の ドレス を 着る{着ていた}
I heard a cry for help.	助け を 呼ぶ 声 が 聞こえる{聞こえた}
Masao studies history under Prof. Ito's guidance.	は 教授 の 指導 の 下{もと} 歴史 を 研究 為る{している}
It is admitted that the hotel is the best in this area.	其の{その} ホテル は 此の{この} 辺り で は 最高 だ と の 折り紙付き{折り紙つき} です
Language is peculiar to man.	言語 は 人間 に 特有{特有の} ものである
This toy car runs on batteries.	此の{この} 玩具{おもちゃ} の 自動車 は 電池 で 動く
Where do you go to school?	学校 は プール の 水 を 月 一回 排水 為る{o 何方{K
She may have to quit her job next month.	彼女 は 来月 退職 為る{し} ねばならない{なければならない} かも知れない{かもしれません}
His speech was not altogether bad.	彼{彼の} 演説 は 満更{まんざら} 捨てる{捨てた} 物{もの} だ{ではなかった}
The weather turned fair.	天気 が 好転 為る{した}
She was required to step down in the office.	彼女 は 其の{その} 会社 を 辞任 為る{する} 様{よう} 求める{求められた}
He is named Jim after his uncle.	彼 は 叔父 の 名前 を と って と 名付ける{名づけられた}
It's natural that Yoko should say a thing like that.	が そう言う{そういう} の も 尤も{もっとも} だ
He sometimes wished to go to extremes.	彼 は 時々{ときどき} 極端{極端な} 手段 に 訴える{訴え} たい{たく} 成る{なった}
She wanted to have paid a visit to India.	彼女 は 印度{インド} に 行く{行き} たい{たかった} のだ が
"He is fresh from college, so he has no experience."	彼 は 大学を出る{大学を出た} 許り{ばかり} で 全く{まったく} 経験 が 無い{ない}
You should pay your rent in advance.	君 は 部屋代 を 前もって 払う 可き{べき} だ
I came to Liverpool by chance.	私 は 偶然{偶然に} に 来る{来た} の だ{だった}
The nun prayed and crossed herself.	尼僧 は 御{お} 祈り を 為る{して} 十字を切る{十字を切った}
There was a new candidate on the ticket at the Democratic convention.	新しい 候補者 が 民主党 の 党大会 で 公認候補 となる{となりました}
I'm a free man.	俺 は 自由{自由な} 男
She took in the washing when it started to rain.	雨 が 降り出す と 彼女 は 洗濯物 を 取り込む{取り込んだ}
"You can't understand this sentence, can you?"	此の{この} 文 の 意味 が 分かる{わからない} のだ{のです} ね
He seems to have been rich before.	彼 は 以前 金持ち だったら{だった} らしい
You don't have to talk so loud.	貴方{あなた} は そんな 大声 で 話す 必要 は 無い{ない}
The hunters aimed at the elephant.	猟師 達{たち} は 銃 で 其の{その} 象 を 狙う{ねらった}
He was standing at the top of the mountain.	彼 は 山 の 頂上 に 立つ{立っていました}
The author made ten mistakes in as many pages.	其の{その} 著者 は 頁{ページ} に 個 の 誤りを犯す{誤りをおかした}
No sooner had it stopped raining than a beautiful rainbow appeared.	雨 が 止む{止んだ} 途端に{とたんに} 奇麗{きれいな} 虹 が 出る{出た}
The roof was damaged by the storm.	屋根 は 嵐 の 被害を受ける{被害を受けました}
The scandal robbed him of a chance to become President.	其の{その} スキャンダル の 為に{ために} 彼 は 大統領 になる 機会 を 失う{失った}
Jane wore the same ribbon as her mother did.	は 彼女{彼女の} 母親 と 同じ リボン を 付ける{つけていた}
The police arrested him for theft.	警察 は 盗み で 彼 を 逮捕 為る{した}
"You need to reverse your vest, it's back to front."	ベスト を 裏返す{裏返さなくちゃ} 表裏 逆 です よ
He has great ability as an artist.	彼 は 芸術家 として 大変{たいへん} 才能 が 有る{ある}
I noticed you entering my room.	君 が 部屋 に 入る{入って} 来る{くる} のに 気付く{気づいた}
"Another war, and we all will be killed."	もう一度 戦争 が 有る{あれば} 我々 は 皆 死ぬ だろう
He was happy at the news of her success.	彼女{彼女の} 成功 を 聞く{聞いて} 彼 は 喜ぶ{喜んだ}
"Drive more slowly, or you'll get a ticket."	もっと ゆっくり 運転 為る{しない} と 違反 切符 を 貰う{もらう} 事になる{ことになる} よ
Follow me and do exactly the way I do it.	私 に 続く{続いて} 私 が 遣る{やる} の と 全く 同じよう{同じように} 遣る{やって} 下さい{ください}
I've got to earn my own living.	私 は 自分 の 生活 費 を 稼ぐ{稼が} 無くてはならない{なくてはならない}
"Asked what exactly a right was, I was at a loss to explain it."	権利 は 正確 には 何 である の か と 聞く{聞かれて} 私 は 説明 に 困る{困った}
What do you say to playing tennis with me?	私 と テニス を 為る{しません} か
Mary and I are in the same class.	と 私 は 同じ クラス だ
Could you tell me which way I should go?	何方{どちら} に 行く{いったら} 良い{いい} の か 教える{教えて} 下さる{くださいません} か
We take our high standard of living for granted.	私たち は 豊か{豊かな} 生活水準 を 当然のこと と 思う{思っています}
Technology will make a lot of progress in the nineties.	年代 に 科学技術 は 大いに{おおいに} 進歩 為る{する} だろう
He was equal to the job.	彼 は 其の{その} 仕事 を 遣る{やれる} 力量 が 有る{あった}
She sometimes has her sister write her term papers.	彼女 は 時々{ときどき} 妹 に レポート を 書く{書かせる}
I got him to polish my shoes.	私 は 彼 に 靴を磨く{靴を磨いて} 貰う{もらった}
What do you think we must do in order to maintain the peace of the world?	世界 の 平和 を 維持 為る{する} には 我々{われわれ} は 如何{どう} 為る{し} ねばならない{なければならない} と 思う{思います} か
Will you join me for a drink?	一緒に 飲む{飲みません} か
We cannot help missing you badly.	私たち は 君 が 居る{いなくて} 迚も{とても} 寂しい{寂しくて} 堪らない{たまらない}
He is a reporter for Time magazine.	彼 は NI{タイム} 誌 の 記者 です
She fled for fear of being caught.	彼女 は 捕まる{つかまる} と 行けない{いけない} ので 逃げる{逃げた}
He is two years older than Ogawa.	彼 は 小川 より 二 才{歳} 年上 です
The house stands by itself.	其の{その} 家 は 一軒 丈{だけ} ぽつり{ぽつんと} 立つ{立っています}
His lack of cooperation defeated our plan.	彼{彼の} 協力 が 無い{なかった} ので 我々 の 計画 は 駄目{だめ} になる{になった}
Her blue shoes go well with that dress.	彼女{彼女の} 青い 靴 は 衣服 に 良く{よく} 似合う{似合っている}
Her wish is to study abroad someday.	彼女{彼女の} 願い は 何時か{いつか} 外国 に 留学 為る{する} 事{こと} だ
She is very fond of standing out.	彼女 は 目立ちたがり屋 だ
I am delighted to meet you.	貴方{あなた} に 会う{お会い} 出来る{できて} 嬉しい
"Acting on your advice, I've decided to exercise more regularly."	貴方{あなた} の 忠告に従う{忠告に従い} 私 は 運動 を もっと 規則正しい{規則正しく} 為る{する} 事{こと} に 決める{決めました}
It overflows into a paper cup.	ペーパーカップ{ペーパー・カップ} の 中 へ と 溢れ出る{あふれでて} 行く{いく}
The young men of Japan are apt to jump on the bandwagon.	日本 の 若者 は 流行 に 乗る 傾向 が 有る{あります}
"Hi, George! How's it going?"	今日は{こんにちは} 如何{どう}
Please pardon me for coming late.	遅れる{遅れて} 申し訳ありません
Is this a radio?	此れ{これ} は ラジオ ですか
I'm too tired to walk any further.	疲れる{疲れていて} 此れ{これ} 以上 歩く{歩けません}
The boy persisted in wearing his hair long.	其の{その} 男の子  は 飽く迄も{あくまでも} 髪の毛 を 伸ばす 事{こと} に 拘る{こだわった}
Everyone attacked my opinion.	皆{みんな} が 僕 の 意見 を 攻撃 為る{した}
Who is responsible for this class?	此の{この} クラス の 担任 は 誰 ですか
He went to America last year to brush up his English.	彼 は 英語 に 磨きをかける 為{ため} 昨年 亜米利加{アメリカ} へ 行く{行った}
I explained to her what the matter was.	何 が 起こる{起こった} の か 彼女 に 説明 為る{した}
"I had intended to finish this yesterday, but I couldn't."	私 は 此れ{これ} を 昨日 仕上げる 積もり{つもり} だ{だった} のだ{のです} が 出来る{できなかった} のだ{のです}
"On encountering the celebrity, the fans asked for his autograph."	ファン 達 は 有名人 と 出くわす なり 彼 に サイン を 求める{求めた}
I'm opposed to any type of war.	私 は どんな 戦争 にも 反対 だ
The Balkan Mountain range runs across Bulgaria from west to east.	山脈 は ブルガリア の 中央 を 東西 に 走る 山脈
He carved marble into a statue.	彼 は 大理石 を 刻む{刻んで} 像 を 作る{作った}
This vending machine isn't working.	此の{この} 自動販売機 動く{動かない} のだ{んです} が
What do you do before breakfast?	貴方{あなた} は 朝食 の 前 に 何{なに} を 為る{します} か
She refused his offer.	彼女 は 彼{彼の} 申し出 を 拒否 為る{した}
She is very attentive to her grandmother.	彼女 は お祖母ちゃん{おばあちゃん} を 大層{たいそう} 大事 に 為る{する}
He is man who I think has never known poverty.	彼 は 貧乏 の 経験 が 無い{ない} と 私 が 思う{思っている} 男 だ
The pencil which writes well is mine.	良く{よく} 書く{書ける} 鉛筆 は 私{私の} 物{もの} です
Nothing is more delightful for me than to talk with him.	私 に取って{にとって} 彼 と 語り合う 程{ほど} 楽しい 事{こと} は 無い{ない}
I'd like to go to Hawaii.	布哇{ハワイ} に 行く{行き} たい 物{もの} です
He seized the pickpocket by the collar.	彼 は 掏摸{すり} の 襟首 を 掴む{掴んだ}
These three pretty girls are all nieces of mine.	此の{この} 三人{３人} の 美しい 少女 は 皆{みな} 私{私の} 姪 です
It wasn't very discreet of you to forget the appointment.	約束 を 忘れる とは 余り{あまり} 慎重 だ{ではなかった} です ね
Happiness lies in contentment.	幸福 とは 満足 為る{する} 事{こと} に 有る
The doctor alerted him to the riskiness of the medicine.	医者 は 彼 に 其の{その} 薬 の 危険性 を 警告 為る{した}
He never fails to do what he says.	彼 は 口に出す 事{こと} は 必ず 為る{する}
I am glad to have helped you last week.	先週 貴方{あなた} の お手伝い が 出来る{できて} 嬉しい{うれしく} 思う{思います}
He is a famous painter and should be treated as such.	彼 は 高名{高名な} 画家 だから そう言う{そういう} 物{もの} として 扱う 可き{べき} だ
You don't have to pay in cash.	現金 で 払う 必要 は 有る{ありません}
I call on him every other day.	私 は 一日 置きに{おきに} 彼 を 訪問 為る{します}
"I was very tired, but I was nevertheless unable to sleep."	私 は 疲れる{疲れていた} が それにも拘わらず{それにもかかわらず} 眠る{眠れなかった}
Some are happy; others unhappy.	幸福{幸福な} 者 も 居る{いれば} 又{また} 不幸{不幸な} 者 も 居る{いる}
"After all, it is talent that counts in music."	結局のところ 音楽 で 物 を 言う の は 才能 だ
People tend to look at others with bias.	人々 は 他人 を 偏見 で 見る{見} 勝ち{がち} だ
Dave never returned to school again.	は 二度と 学校 に 戻る{戻らなかった}
I believe whatever he says.	私 は 彼 の 言う 事 なら 何でも 信じる
"After all his efforts, he also failed this time."	色々{いろいろ} 努力 為る{した} にも関わらず{にもかかわらず} 彼 は 今回 も 失敗 為る{した}
"The prince of darkness means ""Satan""."	暗黒 の 王子 とは 悪魔 の 事{こと} です
This institution came into being after the war.	此の{この} 組織 は 戦後 生まれる{生まれた}
Gold is more precious than iron.	金 は 鉄 よりも  貴重 だ
I've got to get out of here.	そろそろ 失礼 為る{しなくて} は
No boy in the class is taller than Bill.	クラス で より 背の高い 少年 は 居る{いない}
I have known her since she was a baby.	私 は 彼女 が 赤ん坊 の 頃{ころ} から 知る{知っています}
Many a little makes a mickle.	塵{ちり} も 積もる{積もれば} 山 となる
Put it where you like.	好き{好きな} 所{とこ} へ 置く{置けよ}
This is the year 1990.	今年 は 年 です
The suitcase contained nothing but dirty clothes.	スーツケース には 汚れる{汚れた} 服 しか 入る{入ってなかった}
She came home very late.	彼女 は 迚も{とても} 遅い{遅く} 帰宅 為る{した}
The court judged him guilty.	法廷 は 彼 に 有罪 の 判決 を 下す{下した}
I don't make much of his opinion.	私 は 彼{彼の} 意見 を 余り{あまり} 重視 為る{しない}
Lucy turned on the light switch.	は 電灯 の スイッチ を 付ける{つけた}
Did you put a stamp on the envelope?	其の{その} 封筒 に 切手 を 張る{貼りました} か
Did he fail again?	彼 は 又{また} 失敗 為る{した} のだ{のです} か
Start a new paragraph here.	此処{ここ} で 改行 為る{し} なさい
It is surprising that he should not know this.	彼 が 其の{その} 事{こと} を 知る{知らない} とは 驚き だ
She is the messenger.	彼女 は 使いの者 です
The train he was on could no longer be seen.	彼 の 乗る{乗った} 列車 は 見える{見えなく} 成る{なって} 仕舞う{しまった}
"I wish I could live at a more relaxed pace, instead of having to watch the clock all the time."	のんびり とする{とした} 生活 で 時間 に 縛る{縛られない} 生き方 が 出来る{できれば} な
He was always as good as his word.	彼 は 何時も{いつも} 約束を守る{約束を守っていた}
She sang with a beautiful voice.	彼女 は 美しい 声 で 歌う{歌った}
There is no longer any room for doubt.	最早{もはや} 疑い の 余地 は 無い{ない}
They don't have an ear for music.	彼ら{彼等} には 音楽 を 聞く{聴く} 耳 が 無い{ない}
I remarked on the beauty of the landscape.	私 は 風景 の 美しい{美し} さ に就いて{について} 述べる{述べた}
He jumped across the puddle.	彼 は 水溜まり{水たまり} を 飛び越す{飛び越した}
The meaning of words can change according to their context.	言葉 の 意味 は 文脈 に因って{によって} 変わる{変わり} 得る{うる}
She gave me access to her records.	彼女 は レコード を 聞く{聞いて} 良い{いい} と 言う{言って} 呉れる{くれた}
"The dinosaurs in the film ""Jurassic Park"" were true to life."	映画 の 恐竜 は 本物 そっくり だ
Her large income enables her to go to Paris every year.	彼女 は 収入 が 沢山{たくさん} 有る{ある} ので 毎年 巴里{パリ} に 行く 事が出来る{ことが出来る}
He sent fruit and vegetables to his daughter.	彼 は 娘 に 果物 と 野菜 を 送る{送った}
Plain English is a shortcut to the goal of language learning.	プレイン イングリッシュ は 語学 習得 の 近道 です
She was excused attendance at the meeting.	彼女{彼女の} 会 へ の 出席 を 免除 為る{して} 貰う{もらった}
She must come home by 9 at latest.	彼女 は 遅くとも 九 時 には 帰宅 せねばならない
The enemy flung fresh troops into the battle.	敵 は 新 兵力 を 投入 為る{した}
She earns her living by playing the violin.	彼女 は ヴァイオリン{バイオリン} を 弾く{弾いて} 生活 費 を 稼ぐ{稼いでいる}
Shaving off your beard took ten years off you.	髭 剃る{剃ったら} 才{歳} は 若返る{若返って} 見える よ
"From the look on his face, he is in a bad mood now."	彼{彼の} 顔つき からすると 今 は 機嫌が悪い
It is hard for an empty sack to stand straight.	衣食 足りる{足りて} 礼節 を 知る
That was the most exciting concert I have ever been to.	其れ{それ} は 今まで に 行く{行った} 中 で 一番 楽しい コンサート だ{だった}
"However, we can be people of the earth."	然し{しかし} 地球人 になる 事{こと} は 可能 なのだ{なのです}
How on earth did you get into our room?	一体{いったい} どうやって 私たち の 部屋 に 入る{入って} 来る{きた} の か
God above helped us.	天 に 御座す{おわす} 神 の 御{お} 力添え が 有る{あった}
He handed down books from the shelf.	彼 は 本棚 から 本 を 取る{とり} 降ろす{おろした}
Ueno is the station after next.	上野 駅 は 次{次の} 次 です
General admission is $7 for adults.	一般 入場料 は 大人 が ドル です
This car wax gives permanent protection against heavy rain.	此の{この} カーワックス は 大雨 にも 長持ち 為る{する} 保護 となる{となります}
The man reading a book over there is my father.	向こう で 本 を 読む{読でいる} 人 は 私{わたしの} 父 です
Black smoke came out of the chimney.	煙突 から 黒い 煙 が 出る{出て} 来る{きた}
He likes to build model planes.	彼 は 模型飛行機 を 作る の が 好き だ
Please be sure to give my best regards to your father.	必ず 貴方{あなた} の お父さん に 宜しく{よろしく} 伝える{お伝え} 下さい
We can know in advance what excuse he will make.	彼 が どんな 言い訳 を 為る{する} か は 予め{あらかじめ} 分かる{分かって} 仕舞う{しまう}
